##############  ##############
#     #      #  #      #     #
# ### # #### #  # #### # ### # 
#                            #
# ### # ### ###### ### # ### #
#     #     ######     #     #
##### #### ######## #### #####
    #        ####        #    
    # ###### #### ###### #    
    #                    #    
##### #### ###  ### #### #####
      ###  #G     #  ###      
##### #### ######## #### #####
    #                    #    
    # ###### #### ###### #    
    #        ####        #    
##### #### ######## #### #####
#     #     ######     #     #
#             S              #
# ### # #### #  # #### # ### #
#     #      #  #      #     #
##############  ##############